####...####
#.........#
#.........#
#.........#
....#.#....
.....@.....
....#.#....
#.........#
#.........#
#.........#
####...####